5 6
0 0 1 0 0 0
0 2 4 4 2 0
3 2 4 5 0 1
0 2 4 4 2 0
0 0 1 0 0 0