6 6
0 4 0 2 0 1
1 0 2 4 2 0
4 4 4 1 0 4
0 1 2 0 2 0
0 2 0 1 4 2
0 3 0 0 0 0