5 6
0 0 0 0 0 1
0 2 0 3 0 0
2 2 1 1 2 0
0 2 4 1 0 0
4 4 4 0 4 1