5 6
1 0 0 0 0 0
1 0 4 2 4 0
3 0 2 0 2 0
0 0 4 2 4 0
1 0 0 0 0 0