5 5
0 0 0 1 1
0 1 0 1 1
5 4 2 0 0
0 0 1 2 0
3 0 0 0 4