6 6
0 1 4 1 0 0
0 1 0 1 1 1
1 1 2 2 0 4
4 0 2 3 1 1
1 1 1 2 1 0
0 0 1 4 1 0