5 8
1 1 1 0 0 0 0 1
1 4 0 2 1 1 0 1
4 4 2 0 2 0 0 3
4 4 0 2 0 2 0 1
1 1 1 1 1 0 0 1